118,	119,	119,	119,	119,	119,	119,	119,	119,	119,	119,	119,	119,	119,	119,	119,	119,	119,	119,	119,	119,	119,	119,	119,	120,
141,	142,	142,	142,	142,	142,	142,	142,	142,	142,	142,	142,	142,	142,	142,	142,	142,	142,	142,	142,	142,	142,	142,	142,	143,
141,	142,	142,	142,	39,	    142,	142,	142,	142,	142,	142,	142,	39,	    142,	142,	142,	142,	142,	142,	142,	39,	    142,	142,	142,	143,
141,	142,	142,	142,	142,	142,	142,	142,	142,	142,	142,	142,	142,	142,	142,	142,	142,	142,	142,	142,	142,	142,	142,	142,	143,
141,	142,	142,	142,	142,	142,	142,	142,	142,	142,	142,	142,	142,	142,	142,	142,	142,	142,	142,	142,	142,	142,	142,	142,	143,
141,	142,	142,	142,	142,	142,	142,	142,	142,	142,	142,	142,	142,	142,	142,	142,	142,	142,	142,	142,	142,	142,	142,	142,	143,
141,	142,	142,	142,	142,	142,	142,	142,	142,	142,	142,	142,	142,	142,	142,	142,	142,	142,	142,	142,	142,	142,	142,	142,	143,
141,	142,	142,	142,	142,	142,	142,	142,	142,	142,	142,	142,	142,	142,	142,	142,	142,	142,	142,	142,	142,	142,	142,	142,	143,
141,	142,	142,	142,	142,	142,	142,	142,	142,	142,	142,	142,	142,	142,	142,	142,	142,	142,	142,	142,	142,	142,	142,	142,	143,
520,	31,     31,	    520,	520,	520,	520,	520,	520,	520,	54,	    54,	    31,	    31,	    31,	    520,	520,	520,	520,	520,	520,	520,	31,	    31,	    520,
496,	54,     54,	    496,	496,	496,	496,	496,	496,	496,	54,	    54,	    54,	    54,	    54,	    496,	496,	496,	496,	496,	496,	496,	54,	    54,	    496,
566,	77,     77,	    566,	566,	566,	566,	566,	566,	566,	54,	    54,	    77,	    77,	    77,	    566,	566,	566,	566,	566,	566,	566,	77,	    77,	    566,
141,	142,	142,	142,	142,	142,	142,	142,	142,	142,	142,	142,	142,	142,	142,	142,	142,	142,	142,	142,	142,	142,	142,	142,	143,
141,	142,	142,	142,	142,	142,	142,	142,	142,	142,	142,	142,	142,	142,	142,	142,	142,	142,	142,	142,	142,	142,	142,	142,	143,
141,	142,	142,	142,	142,	142,	142,	142,	142,	142,	142,	142,	142,	142,	142,	142,	142,	142,	142,	142,	142,	142,	142,	142,	143,
141,	142,	142,	142,	142,	142,	142,	142,	142,	142,	142,	142,	142,	142,	142,	142,	142,	142,	142,	142,	142,	142,	142,	142,	143,
141,	142,	142,	142,	142,	142,	142,	142,	142,	142,	142,	142,	142,	142,	142,	142,	142,	142,	142,	142,	142,	142,	142,	142,	143,
141,	142,	142,	142,	43,	    142,	142,	142,	142,	142,	142,	142,	43,	    142,	142,	142,	142,	142,	142,	142,	43,	    142,	142,	142,	143,
141,	142,	142,	142,	142,	142,	142,	142,	142,	142,	142,	142,	142,	142,	142,	142,	142,	142,	142,	142,	142,	142,	142,	142,	143,
164,	165,	165,	165,	165,	165,	165,	165,	165,	165,	165,	165,	165,	165,	165,	165,	165,	165,	165,	165,	165,	165,	165,	165,	166
